NO ./texture/Test/brick.xpm
SO ./texture/Test/metal.xpm
WE ./texture/Test/pebbles.xpm
EA ./texture/Test/wood.xpm

F 255,100, 0
C 225,255, 255

11111111111111111111111111111111111111111111111111111111111111111111111111111111
10000000000000000001100000000000000000011000000000000000000110000000000000000001
10000000000000000000000000000000000000000000000000000000000000000000000000000001
100000000W0000000001100000000000000000001000000000000000000110000000000000000001
10000000000000000001100000000000000000011000000000000000000110000000000000000001
10000000000000000001100000000000000000011000000000000000000110000000000000000001
11111111111111111111111111111111111111111111111111111111111111111111111111111111
