NO ./texture/brick.xpm
SO ./texture/metal.xpm
WE ./texture/pebbles.xpm
EA ./texture/wood.xpm

F 255,100, 0
C 225,255, 255

11111111111111111111
10000000000000000001
10000000000000000001
100000000S0000000001
10000000000000000001
10000000000000000001
11111111111111111111
