NO ./texture/brick.xpm
SO ./texture/vroum.xpm
WE ./texture/test.xpm
EA ./texture/wood.xpm

F 255,100, 0
C 225,255, 255

1111111111111111111
1001001001001001001
1010101010101010101
100000000S000000001
1000010000100001001
1000000000000000001
1111111111111111111
