NO ./texture/Test/test.xpm
SO ./texture/Test/test.xpm
WE ./texture/Test/test.xpm
EA ./texture/Test/test.xpm

F 0,0, 0
C 0,000,255

1111111111111111111
1001001001001001001
1010101010101010101
100000000S000000001
1000010000100001001
1000000000000000001
1111111111111111111
