NO ./texture/SquidGame/rose.xpm
SO ./texture/SquidGame/rose.xpm
WE ./texture/SquidGame/rose.xpm
EA ./texture/SquidGame/rose.xpm

F 240, 89, 132
C 1 , 1 , 1

11111
1111N
11111